NO ./srcs/textures/wall_no.xpm
SO ./srcs/textures/wall_so.xpm
WE ./srcs/textures/wall_we.xpm
EA ./srcs/textures/wall_ea.xpm

F 220,100,0
C 225,30,0

11111111111
10000000001
10000000101
10000W00001
10000000101
10000000001
11111111111
