
F  31,31,31

           NO ./srcs/textures/wall_no.xpm
       SO ./srcs/textures/wall_so.xpm
C        225,30,0





    WE ./srcs/textures/wall_we.xpm
  EA ./srcs/textures/wall_ea.xpm

11111
 11 W1
 0 11
 11111
111111
