NO ./textures/wall_no.xpm
SO ./textures/wall_so.xpm
WE ./textures/wall_we.xpm
EA ./textures/wall_ea.xpm

F 220,100,0
C 225,30,0

1111111111
10000011111
100N001  101
10000011111
111111111