11111111111
10000000111
10001001111
10000011101
10W00110001
10000000001
11111111111
